7an	tujuan
@	di
ababil	abg labil
abis	habis
acc	akun
ad	ada
adaa	ada
adaaaa	ada
ademm	adem
adh	aduh
adlah	adalah
adlh	adalah
adm	admin
adoh	aduh
ads	iklan
afaik	as far as i know
aff	affiliate
affialiates	affiliate
affilate	affiliate
affiliat	affiliate
affiliateaku	affiliate aku
affiliateakun	affiliate akun
affiliateapapun	affiliate apapun
affiliatekita	affiliate kita
affiliateku	affiliate ku
affiliateleh	affiliatelah
affiliates	affiliate
affliator	affiliasi
afiliet	affiliate
affilite	affiliate
affliliate	affiliate
aga	agak
aha	tertawa
ahaha	haha
aing	saya
aiiya	aduh
aj	saja
aja	saja
ajaa	saja
ajaaa	saja
ajaah	saja
ajaahh	saja
ajahh	saja
ajalah	sajalah
ajapunya	saja punya
ajarin	mengajari
aje	saja
ajep-ajep	dunia gemerlap
ajg	anjing
ajgg	anjing
ajh	saja
ajj	saja
ak	saya
aka	dikenal juga sebagai
akaun	akun
akhirnyaaaaa	akhirnya
akhirakhir	akhir-akhir
akika	aku
akko	aku
akkoh	aku
akku	aku
akn	akan
ako	aku
aktifin	mengaktifkan
aktiv	aktif
akukamu	aku kamu
akunakun	akun
akunn	akun
akuu	aku
akuuu	aku
akuwh	aku
akyu	aku
alahai	aduh
alatalat	alat-alat
alay	norak
aljasa	asal jadi saja
allo	halo
aloo	halo
alooo	halo
alow	halo
ama	sama
amann	aman
amanahnipu	amanah menipu
ambik	ambil
ambilin	ambilkan
ambl	ambil
anakbayi	anak bayi
anaknyaaaaa	anaknya
ancur	hancur
angett	hangat
angkutt	angkut
anj	anjing
anjay	anjing
anjenggg	anjing
anjenggggg	anjing
anjg	anjing
anjgg	anjing
anjggg	anjing
anjinggg	anjing
anjir	anjing
anjirrr	anjing
anjirrrr	anjing
anjr	anjing
anjrit	anjing
anjrittttt	anjing
ank	anak
anon	anonim
anter	antar
anying	anjing
anyinkkk	anjing
anw	anyway
ap	apa
ap2	apa-apa
apaan	apa
apaapa	apa-apa
apakek	apa saja
apasih	apa sih
apayak	apa ya
ape	apa
apes	sial
apk	aplikasi
aplot	unggah
app	aplikasi
apprem	aplikasi premium
aps	apa
apva	apa
aq	saya
aqu	aku
aquwh	aku
asap	sesegera mungkin
asbun	asal bunyi
aseek	asyik
aseekk	asyik
asek	asyik
asekk	asyik
aseknya	asyiknya
asem	asam
aslianya	aslinya
asliii	asli
asoy	asyik
aspal	asli tetapi palsu
astrojim	astagfirullahaladzim
astul	asal tulis
atauuu	atau
atay	atau
ath	kalau begitu
ato	atau
atuh	kalau begitu
au	alternate universe
au ah	tidak mau tahu
ava	avatar
awak	saya
awalny	awalnya
aws	awas
ay	sayang
ayang	sayang
ayank	sayang
ayok	ayo
ayookk	ayo
ayooo	ayo
ayuukk	ayo
b4	sebelum
bacain	membacakan
bacot	banyak bicara
bagiin	membagikan
bagusss	bagus
bajucelanakerudungrok	baju celana kerudung rok
bajumurah	baju murah
bakaan	bakalan
bales	balas
balesan	balasan
balesannya	balasannya
ban	banned
bandes	bantuan desa
bangdes	pembangunan desa
bandinginnya	membandingkannya
badmin	badminton
bangedh	banget
bangeeet	banget
bangeeettt	banget
bangeet	banget
bangett	banget
bangettt	banget
bangettttt	banget
bangggg	bang
bangke	bangkai
bangkotan	tua
bangsaaat	bangsat
banhak	banyak
banpol	bantuan polisi
banpres	bantuan presiden
banpur	bantuan tempur
bansarkas	bantuan sarana kesehatan
banyakin	perbanyak
banyakkk	banyak
barangbarang	barang-barang
baruu	baru
basbang	basi
batreny	baterainya
bawak	bawa
bazis	badan amal, zakat, infak, dan sedekah
bb	berat badan
bbrp	beberapa
bcanda	bercanda
bcoz	karena
bdg	bandung
beb	sayang
bebasss	bebas
bedain	bedakan
begajulan	nakal
begok	bego
bethol	betul
bejibun	banyak
belii	beli
beliiii	beli
beliin	belikan
belikan	membelikan
belinyaa	belinya
belinyaaa	belinya
belom	belum
benarbenar	benar-benar
bencong	banci
bener	benar
beneran	benar
benerannya	sebenarnya
bentar	sebentar
bentarr	sebentar
berasa	merasa
ber2	berdua
ber3	bertiga
berbelanjaaa	berbelanja
berbeza	berbeda
berbisnes	berbisnis
berdikari	berdiri di atas kaki sendiri
beresin	membereskan
berharihari	berhari-hari
berkalikali	berkali-kali
berkalikalibeneran	berkali-kali benar
bermutual	berteman
bersihin	bersihkan
bertahuntahun	bertahun-tahun
bertemann	berteman
besti	sahabat
bestie	sahabat
bestiee	sahabat
bestieepasti	sahabat pasti
bestiii	sahabat
bet	banget
bete	bosan
beti	beda tipis
beud	banget
beut	banget
beza	beda
bf	boyfriend
bg	abang
bgd	banget
bgmn	bagaimana
bgs	bagus
bgsd	bangsat
bgst	bangsat
bgt	banget
bgtt	banget
bgttt	banget
bgttttt	banget
bgus	bagus
bhkn	bahkan
bhubu	tidur
biasaa	biasa
bijimane	bagaimana
bimbuluh	bimbingan dan penyuluhan
bingungg	bingung
bintal	bimbingan mental
binus	universitas bina nusantara
bisaa	bisa
bisadan	bisa dan
bisabisa	bisa-bisa
bisi	kalau-kalau
bisikin	bisikan
bjir	anjing
bkin	bikin
bkl	akan
bkn	bukan
bknnya	bukannya
bl	beli
blegug	bodoh
blg	bilang
blh	boleh
blm	belum
bln	bulan
block	blokir
blockin	memblokir
bloggersocial	blogger social
blok	blokir
blokin	blokir
blokirin	memblokir
bls	balas
blueee	twitter blue
blum	belum
bnchi	benci
bnci	benci
bneran	yang benar
bngung	bingung
bngt	banget
bngtt	banget
bnr	benar
bnran	yang benar
bnrr	benar
bntu	bantu
bnyak	banyak
bnyk	banyak
bo	prostitusi online
bocil	bocah cilik
bodo	bodoh
bodor	lucu
bohay	badan aduhai
bokap	ayah
bokep	video porno
bokepamp	video porno
boker	buang air besar
bokin	pacar
bokis	bohong
bole	boleh
bolee	boleh
boleeh	boleh
bolehh	boleh
boljug	boleh juga
bolot	bodoh
bonek	bocah nekat
bonyok	ayah ibu
bosen	bosan
boti	homoseksual
boyeh	boleh
bpk	bapak
br	baru
brang	barang
brb	segera kembali
brbandibg	berbanding
brg	bareng
brkali	berkali
brngkt	berangkat
bro	saudara laki-laki
brp	berapa
brrti	berarti
bru	baru
brur	saudara laki-laki
bs	bisa
bsa	bisa
bsbsnya	bisa-bisanya
bsen	bosan
bsk	besok
bt	bosan sekali
bt	buat
btw	ngomong-ngomong
bu_bu	tidur
buatkondangan	untuk undangan
buatt	buat
buaya	tidak setia
bub	block-unblock
bubarin	bubarkan
bubbu	tidur
buber	buka bersama
bubu	tidur
budgetnya	anggarannya
buh	bubuh
bujubune	luar biasa
bukak	buka
bukann	bukan
bulain	bulan
bumil	ibu hamil
burem	buram
buser	buru sergap
busettt	buset
busui	ibu menyusui
butuhin	butuhkan
buzzernya	buzzer nya
bw	bawa
bwhn	bawahan
bwt	buat
bwtkeluarga	buat keluarga
byar	bayar
byk	banyak
byr	bayar
byrin	bayarkan
c8	chat
cabal	sabar
cabut	pergi
cadas	keren
caem	cakep
cairin	mencairkan
cairinconvert	mencairkan konversi
cairinnya	mencairkannya
cakepp	cakep
calo	makelar
cam	camera
cama-cama	sama-sama
camne	bagaimana
camni	seperti ini
camtu	seperti itu
can	belum
cangcut	celana dalam
cantikk	cantik
cantulll	cantik
capcus	pergi
cape	capek
capeee	capek
caper	cari perhatian
capernya	cari perhatiannya
caramempromosikan	cara mempromosikan
caranyaa	caranya
cariin	mencari
caur	jelek
cs	customer service
ce	cewek
cekak	tidak ada uang
cekal	cegah tangkal
cekidot	coba lihat
cekk	cek
cekout	checkout
cekoutt	checkout
cemane	bagaimana
cemen	penakut
cemplungin	cemplungkan
cendall	sandal
cengengesan	tertawa
ceper	pendek
cepet	cepat
ceu	kakak perempuan
cew	cewek
cewe	cewek
cfdkonserwisudaanor	cfd konser wisudaan or
chekk	check
chekout	checkout
chuyunk	sayang
cht	chat
cibuk	sibuk
cihuy	hore
cimeng	ganja
cin	cinta
cingtaaa	cinta
cipika cipiki	cium pipi kanan cium pipi kiri
ciwi	cewek
ciye	cie
ciyh	sih
ckck	ck
ckepp	cakep
ckp	cakep
ckp	cukup
clbk	cinta lama bersemi kembali
cma	cuma
cmiiw	correct me if i'm wrong
cmn	cuman
cmne	bagaimana
cmpr	campur
cmpur	campur
cmtula	seperti itulah
cnenk	senang
co	checkout
cobain	mencoba
cock	cocok
cocoki	shopee cocoki
comell	comel
comot	mengambil
comparekan	bandingkan
condi	conditioner
cong	banci
congor	mulut
conlok	cinta lokasi
cow	cowok
cowwyy	maaf
coz	karena
cp	siapa
cpa	siapa
cpe	capek
cppa	siapa
cppe	capek
cpt	cepat
cptt	cepat
cpttt	cepat
cr	cara
cs	customer service
cuan	uang
cuannya	uangnya
cucok	cocok
cuek	tidak acuh
cuex	cuek
cuman	cuma
cumi	cuma miscall
cung	tunjuk tangan
cungg	tunjuk tangan
cungkring	kurus tinggi
cups	culun
cupu	culun
curanmor	pencurian kendaraan bermotor
curas	pencurian dengan kekerasan
curcol	curahan hati colongan
curhat	curahan hati
cwek	cewek
cwok	cowok
cyin	cinta
cz	karena
d	di
dadakan	mendadak
daftargabung	daftar gabung
daftarin	daftarkan
dagh	sudah
dah	sudah
dalem	dalam
daleman	pakaian dalam
damang	sehat
dapatin	mendapatkan
dapet	dapat
dapetin	mendapatkan
dapetnya	dapatnya
dare	tantangan
darimanee	dari mana
dateng	datang
de	adik
debutin	ditampilkan pertama kali
dech	deh
dek	adik
deket	dekat
demen	suka
denger	dengar
dengerin	mendengarkan
depo	deposit
deselingi	diselingi
dewasaganjaliquid	dewasa ganja liquid
deyh	deh
dftar	daftar
dftr	daftar
dg	dengan
dgangan	dagangan
dgn	dengan
dh	deh
diakalin	mengakali
diakuaku	diakui
diancurin	dihancurkan
dianggurin	dibiarkan
diapprove	disetujui
diaorang	mereka
dibales	dibalas
dibalikin	dikembalikan
dibekuin	dibekukan
dibio	dibiografi
diblend	dicampur
diblock	diblokir
dibolehin	dibolehkan
dibutuhin	dibutuhkan
dibuzzerin	dibuzzerkan
dibwa	dibawa
dibwh	dibawah
dicekout	dicheckout
dichackout	dicheckout
diclaim	diklaim
dico	dicheckout
didaftarin	didaftarkan
didengarkarena	didengar karena
diduitin	monetisasi
difolback	difollback
diem	diam
diemin	diamkan
digosipin	digosipkan
digunain	digunakan
dihubungin	dihubungkan
diinvite	diundang
dijadiin	dijadikan
dijelasin	dijelaskan
dijoinin	dimasukkan
dikit	sedikit
dikitdikit	sedikit-sedikit
dikumpulin	dikumpulkan
dilaporin	dilaporkan
dilewatin	dilewatkan
diliatnya	dilihatnya
dimaafin	dimaafkan
dimall	di mall
dimana2	dimana-mana
dimasukin	dimasukkan
diminati	minat
dimintain	diminta
dimintak	diminta
dimna	dimana
dipadupadankan	dipadu padankan
dipake	digunakan
dipakein	dipakaikan
dipanjangin	dipanjangkan
dipatahin	dipatahkan
dipromot	dipromosikan
diqbntu	dibantu
diramein	disebarkan
direport	dilaporkan
disalahin	disalahkan
disambungin	disambungkan
disangkasangka	disangka-sangka
disc	diskon
diselipin	diselipkan
disinidisana	disini disana
diskonny	diskonnya
disono	di sana
disosmed	di sosial media
ditanyain	ditanyakan
ditaroh	ditaruh
ditautin	ditautkan
ditempatsosmed	di tempat sosial media
dititipin	dititipkan
ditungguin	ditunggu
diuber	dikejar
dket	dekat
dkit	sedikit
dkk	dan kawan-kawan
dkt	dekat
dl	dulu
dll	dan lain-lain
dlm	dalam
dlu	dulu
dm	direct message
dmkah	kirim pesan kah
dmn	dimana
dngn	dengan
doain	doakan
doang	saja
dodol	bodoh
doi	dia
doku	uang
dom	domisili
dongg	dong
donggg	dong
don juan	playboy
dongs	dong
donlot	unduh
doongg	dong
dpet	dapat
dpt	dapat
dr	dari
dri	dari
drmana	darimana
drmn	darimana
drpd	daripada
drtd	dari tadi
drtadi	dari tadi
dsb	dan sebagainya
dsini	di sini
dst	dan seterusnya
dstu	disitu
dtg	datang
dugem	dunia gemerlap
duh	aduh
duid	uang
duit	uang
duitnya	uangnya
duluan	dahulu
duluya	dulu ya
dunno	don't know
dupe	tiruan
duren	durian
dy	dia
ecom	ecommerce
ed	edisi
edan	gila
edu	edukasi
edyan	gila
egak	tidak
egp	emang gue pikirin
eike	aku
eke	aku
ekeu	aku
ello	halo
elo	kamu
elu	kamu
eluuuuu	kamu
emang	memang
emangnya	memangnya
emg	memang
emng	memang
emte	makan teman
enakeun	enak
enakeunnnn	enak
endak	tidak
eneg	muak
engagementnya	engagement nya
engga	tidak
enggak	tidak
entar	nanti
envy	iri
etc	dan lain-lain
ex	mantan
ext	extension
faham	paham
fak	fuck
fakw	fake
falbackk	follow back
fallaw	follow
fav	favorit
fax	facsimile
fb	facebook
fifo	first in first out
fikir	pikir
finek	finansial ekonomi
fllw	follow
folbek	follow back
foll	follow
folls	followers
freelancerupwork	freelancer upwork
fwd	diterukan
fyi	sebagai informasi
ga	tidak
gaa	tidak
gaaa	tidak
gaak	tidak
gada	tidak ada
gaada	tidak ada
gaasik	tidak menyenangkan
gabakal	tidak bakal
gabanyak	tidak banyak
gabikin	tidak membuat
gabisa	tidak bisa
gabisaaa	tidak bisa
gaboleh	tidak boleh
gabut	tidak ada aktivitas
gabutan	mengisi waktu luang
gacor	keren
gada	tidak ada
gadapet	tidak mendapat
gag	tidak
gahar	sangar
gaharus	tidak harus
gais	teman-teman
gaisaa	tidak bisa
gaiss	teman-teman
gaisss	teman-teman
gaje	tidak jelas
gajelas	tidak jelas
gak	tidak
gakepagang	tidak terpegang
gakla	juga lah
gak papa	tidak apa-apa
gakseru	tidak menyenangkan
gaksih	tidak sih
gamau	tidak mau
gamenya	permainannya
gamuncul	tidak muncul
gan	juragan
ganemu	tidak ketemu
gangerti	tidak mengerti
ganyaman	tidak nyaman
gapapa	tidak apa-apa
gapapaa	tidak apa-apa
gaperlu	tidak perlu
gapernah	tidak pernah
gaptek	gagap teknologi
garagara	gara-gara
garukan	penggaruk
gasi	tidak sih
gasihh	tidak sih
gaspol	tancap gas
gaskeun	lanjutkan
gasskeunn	lanjutkan
gasss	lanjutkan
gasuka	tidak suka
gatel	gatal
gatau	tidak tahu
gatek	gagap teknologi
gatot	gagal total
gausa	tidak usah
gausah	tidak usah
gawe	kerja
gax	tidak
gays	teman-teman
gbs	tidak bisa
gda	tidak ada uang
gdm	grup pesan langsung
gebetan	orang yang disuka
gedi	besar
geer	gede rasa
gegara	gara-gara
geje	tidak jelas
gelembungbubble	gelembung bubble
gelo	gila
gemach	gemas
gemasss	gemas
gembungg	gembung
gemec	gemas
gemecccc	gemas
gemes	gemas
gemesh	gemas
gemeshhhhh	gemas
gemess	gemas
gemeesss	gemas
gemoy	menggemaskan
gemoyy	menggemaskan
gemoyyy	menggemaskan
gemp	gempa
gempnya	gempanya
gemus	gemas
gemuy	gemas
gepeng	gelandangan dan pengemis
gercep	gerak cepat
ges	teman-teman
getol	gigih
gada	tidak ada
gf	girlfriend
ggada	tidak ada
ghiey	lagi
ghiy	lagi
gi	lagi
gile	gila
gimama	bagaimana
giman	gigi mancung
gimana	bagaimana
gimmick	gimik
gini	begini
ginian	begini
ginii	begini
gino	gigi nongol
girlskalian	girls kalian
gitchu	gitu
githu	gitu
gitu	begitu
gituan	begituan
gituu	begitu
gj	tidak jelas
gk	tidak
gkjd	tidak jadi
gmana	bagaimana
gmbr	gambar
gmn	bagaimana
gmna	bagaimana
gn	begini
gnti	ganti
goblog	goblok
goblok	bodoh
gokil	gila
golput	golongan putih
gomawo	terima kasih
gombal	suka merayu
gontaganti	gonta-ganti
gowes	mengayuh sepeda
gpl	tidak pakai lama
gpny	tidak punya
gpp	tidak apa-apa
gprnh	tidak pernah
gr	gram
grgr	gara-gara
greget	gereget
gretong	gratis
gretongan	gratisan
grub	grup
gt	begitu
gtau	tidak tahu
gtu	begitu
gtw	tidak tahu
gua	saya
guaa	saya
guasih	saya sih
gue	saya
guis	teman-teman
gugel	google
gumuss	gemas
guoblok	goblok
guys	teman-teman
guyss	teman-teman
guysss	teman-teman
guyyss	teman-teman
gw	saya
gweh	saya
gwehj	saya
gwejh	saya
gws	cepat sembuh
ha	tertawa
haai	hai
habistu	setelah itu
hadehhh	aduh
hadeuhhh	aduh
haghaghag	tertawa
haha	tertawa
hahah	tertawa
hahaha	tertawa
hahahaha	tertawa
hahhahha	tertawa
haihaiii	halo
haii	hai
haiidd	haid
haiiii	hai
hakhak	tertawa
hallal	halal
hallooo	halo
hallow	halo
hallowww	halo
haloo	halo
halooo	halo
haloow	halo
handak	bahan peledak
hankam	pertahanan dan keamanan
hansip	pertahanan sipil
hape	handphone
harini	hari ini
haritu	hari itu
hasilin	menghasilkan
hasilny	hasilnya
hasilnyaa	hasilnya
hasilpositif	hasil positif
hastag	hashtag
hatihati	hati-hati
hatti	hati
hay	hai
hayuk	ayo
hayuuuu	ayo
hb	habis
hbs	habis
heartsignal	heart signal
hedon	hedonisme
heelppp	tolong
helpp	tolong
helppp	help
hehe	he
hellooo	halo
hellow	halo
helloww	halo
hellowww	halo
helo	halo
heloo	halo
helow	halo
hesteg	hashtag
hewwo	halo
hey	hai
heyyy	hai
hi	hai
hihi	tertawa
hihihi	tertawa
hii	hai
hiii	hai
hiiii	hai
hiiiii	hai
hiks	sedih
hlm	halaman
hlng	hilang
hlo	halo
hmu	hit me up
hny	hanya
hnya	hanya
hoax	isu bohong
hola	halo
houm	rumah
hr	hari
hrs	harus
hrus	harus
ht	hashtag
hubad	hubungan angkatan darat
hubdar	perhubungan darat
hubla	perhubungan laut
hubungin	menghubungkan
huff	mengeluh
huft	mengeluh
huhu	sedih
hulaa	halo
hum	rumah
humas	hubungan masyarakat
humz	rumah
iaitu	yaitu
idk	saya tidak tahu
idunno	i don't know
idup	hidup
ig	instagram
igku	instagramku
ignya	instagramnya
ijo	hijau
ikutin	mengikuti
ikutinn	mengikuti
ilang	hilang
ilangin	hilangkan
ilfeel	tidak suka
ilfil	tidak suka
imba	jago sekali
imho	in my humble opinion
imo	in my opinion
imoet	imut
imoetz	imut
incomenya	pendapatannya
indisit	indosat
indo	indonesia
info	informasi
infoin	menginformasikan
inih	ini
inii	ini
iniiii	ini
iniyukkk	ini ayo
inter	internasional
irt	ibu rumah tangga
issa	it's a
isiny	isinya
item	hitam
itung	hitung
itungan	hitungan
ituu	itu
ituuu	itu
iy	iya
iye	iya
iyo	iya
ja	saja
jaa	saja
jablay	jarang dibelai
jadiin	jadikan
jadul	jaman dulu
jaim	jaga image
jajaaannnnn	jajan
jajannnn	jajan
jalanjalan	jalan-jalan
jancuk	anjing
jangannn	jangan
jann	jangan
janogos	januari agustus
jastag	jasa tag
jastip	jasa titip
jaswar	jasa rebutan
jatohnya	jatuhnya
jayus	tidak lucu
jbjb	join bareng
jd	jadi
jdi	jadi
jdii	jadi
jdikan	jadikan
je	saja
jela	sajalah
jelasin	menjelaskan
jem	jam
jembreng	buka lebar
jepitikat	jepit ikat
jfb	janji follow back
jg	juga
jga	juga
jgn	jangan
jgnkan	jangankan
jijay	jijik
jir	anjing
jka	jika
jkt	jakarta
jlek	jelek
jln	jalan
jmlh	jumlah
jngan	jangan
jnj	janji
joinin	gabungkan
jomblo	tidak punya pacar
jth	jatuh
jualanshopee	jualan shopee
jualin	menjual
jubir	juru bicara
judol	judi online
jugaaa	juga
jugaaaa	juga
jugak	juga
julid	nyinyir
jurdil	jujur adil
jutek	galak
jwb	jawab
jwban	jawaban
k	ke
ka	kakak
kaah	kah
kaak	kakak
kaan	kan
kab	kabupaten
kabag	kepala bagian
kabor	kabur
kacian	kasihan
kacrut	kacau
kadit	kepala direktorat
kadiv	kepala divisi
kadoin	memberi hadiah
kadooo	kado
kaga	tidak
kahh	kah
kagak	tidak
kaka	kakak
kakanya	kakaknya
kalean	kalian
kalo	kalau
kalo	kalau
kampret	sialan
kamtib	keamanan dan ketertiban
kamtibmas	keamanan dan ketertiban masyarakat
kamuh	kamu
kamuwh	kamu
kamyu	kamu
kang	kakak laki-laki
kannn	kan
kanwil	kantor wilayah
kapt	kapten
karna	karena
kasat	kepala satuan
kasi	beri
kasian	kasihan
kasubbag	kepala subbagian
kasubbid	kepala subbidang
kat	di
katakata	kata-kata
kating	kakak tingkat
katrok	kampungan
kau	kamu
kaw	kamu
kawai	imut
kawaii	imut
kawaiiii	imut
kayanya	kayaknya
kbar	kabar
kbr	kabar
kcian	kasihan
kdg	kadang
kdu	harus
kea	kayak
kebaca	terbaca
kebanned	dilarang
keburu	terlanjur
kec	kecamatan
kece	keren
kecee	keren
kecik	kecil
kedekut	pelit
kedubes	kedutaan besar
keitung	terhitung
keje	kerja
kejurnas	kejuaraan nasional
kek	seperti
kekeuh	keras kepala
keknya	kayaknya
kel	kelurahan
kelar	selesai
keliatan	kelihatan
kelilink	keliling
keluarin	mengeluarkan
kemanamana	kemana-mana
kemaren	kemarin
kenalin	kenalkan
kenapaa	kenapa
kendor	kendur
keneh	masih
kepake	terpakai
kepengen	mau
kepikiran	terpikirkan
kepingin	mau
kepo	mau tahu urusan orang
kepoin	mencari tahu
kepotong	terpotong
kepsek	kepala sekolah
kerana	karena
keranjangin	masukkan ke keranjang
kere	tidak punya uang
keringetan	berkeringat
kerjaanfreelance	pekerjaan freelance
kerjakuliahhangout	kerja kuliah hangout
kerjaside	kerja sampingan
kerje	kerja
kesbang	kesatuan bangsa
kesel	kesal
kesian	kasihan
kesini	ke sini
kesra	kesejahteraan rakyat
kesuspend	tertangguh
ketauan	ketahuan
ketce	keren
ketrangan	keterangan
ketrima	diterima
keukeuh	keras kepala
kget	kaget
kgiatan	kegiatan
kgk	tidak
khabar	kabar
khan	kan
kibul	bohong
kibus	kaki busuk
kiloann	kiloan
kimpoi	kawin
kipop	kpop
kirain	kiranya
kirakira	kira-kira
kirimin	mengirimkan
kitaa	kita
kiyowo	menggemaskan
kiyowoo	menggemaskan
kk	kakak
kka	kakak
kl	kalau
klean	kalian
klenn	kalian
klian	kalian
klianz	kalian
klo	kalau
kloter	kelompok terbang
kluarga	keluarga
klw	kalau
klwrga	keluarga
km	kamu
kmn	kemana
kmaren	kemarin
kmari	kemari
kmps	kampus
kmpus	kampus
kmrn	kemarin
kmu	kamu
kn	kan
knal	kenal
kndala	kendala
knl	kenal
knp	kenapa
knpa	kenapa
kntl	alat kelamin pria
kntol	alat kelamin pria
ko	kenapa
kobisa	bagaimana bisa
kodya	kota madya
kodontodol	alat kelamin pria
kog	kok
koinn	koin
kokk	kok
komdis	komisi disiplin
komen	komentar
komenan	komentar
komenin	mengomentari
komentarin	mengomentari
komis	komisi
komisen	komisi
komisiny	komisinya
komisyen	komisi
kompi	komputer
komsov	komunis sovyet
komtiong	komunis Tiongkok
komunikasiny	komunikasinya
kondangan	undangan
konek	tersambung
konekin	menyambungkan
kongkow	kumpul bareng teman-teman
konjen	konsulat jenderal
konsepin	konsepkan
kontenpraktis	konten praktis
kopdar	kopi darat
koq	kok
korang	kalian
korup	korupsi
kot	sepertinya
kpd	kepada
kperluan	keperluan
kpn	kapan
kptsan	keputusan
krenz	keren
krg	kurang
krik	garing
kripik	keripik
krm	kirim
krn	karena
krna	karena
krudung	kerudung
kt	kita
ktauan	ketahuan
ktmu	ketemu
ktny	katanya
ktr	kantor
kubeli	aku beli
kudu	harus
kumpulin	kumpulkan
kuncikeychain	kunci keychain
kupake	aku pakai
kuper	kurang pergaulan
kupukupu	kupu-kupu
kuq	kok
kurleb	kurang lebih
kuu	aku
kuy	ayo
kuyy	ayo
kuyyy	ayo
kw	imitasi
ky	seperti
kya	kayak
kyeopta	lucu
kyk	seperti
kykny	kayaknya
kyknya	kayaknya
kyuuut	imut
la	lah
laa	lah
laamaksudnya	lah maksudnya
lagiii	lagi
laka	kecelakaan
lakuin	melakukan
lakilaki	laki-laki
lali	lupa
lam	salam
lamaaaa	lama
lamalama	lama-lama
lambreta	lambat
lamp	lampiran
lansia	lanjut usia
lansung	langsung
lanud	landasan udara
lapas	lembaga pemasyarakatan
laprak	laporan praktik
latgab	latihan gabungan
lbur	libur
ldr	long distance reletionship
lebay	berlebihan
lebi	lebih
leh	boleh
leh	boleh
lekong	laki-laki
lelet	lambat
lemot	lambat
lengkapin	melengkapi
lepasni	setelah ini
lepastu	setelah itu
letsgooo	let's go
lg	lagi
lgi	lagi
lgkp	lengkap
lgsg	langsung
lhooooo	loh
lht	lihat
liat	lihat
liatnya	melihatnya
likecomment	like comment
likee	like
likert	like rt
linklink	link
linkproduk	link produk
linktwit	link twitter
linmas	perlindungan masyarakat
litbang	penelitian dan pengembangan
livenahh	live nah
livestrean	livestream
liveyuk	live yuk
lmao	laughing my ass off
lmyan	lumayan
lmyn	lumayan
ln	luar negeri
lngkp	lengkap
lngsung	langsung
lo	kamu
loch	loh
loe	kamu
logik	logika
logoutlogin	logout login
lojik	logis
loker	lowongan kerja
lol	tertawa
lola	lambat berfikir
lom	belum
looh	loh
louph	cinta
loupz	cinta
low	kalau
lowh	kamu
lp	lupa
lps	lepas
lsg	langsung
lu	kamu
luamayan	lumayan
luangin	meluangkan
luber	langsung, umum, bebas, dan rahasia
luchu	lucu
luchuw	lucu
luckkkk	luck
lucukk	lucu
lucututorialsketsadll	lucu tutorial sketsa dan lain-lain
lucuu	lucu
lucuuu	lucu
luff	cinta
lum	belum
lumutan	tua
lupaa	lupa
luph	cinta
lutcueee	lucu
luthu	lucu
lvl	level
lw	kamu
lwat	lewat
lwn	lawan
lwt	lewat
maaciii	terima kasih
maacih	terima kasih
maaciw	terima kasih
maba	mahasiswa baru
mabal	bolos
mabes	markas besar
macammacam	macam-macam
macamana	bagaimana
macamni	macam ini
macem	macam
macem-macem	macam-macam
macih	masih
madesu	masa depan suram
maem	makan
maen	main
magabut	makan gaji buta
mager	malas gerak
mahalmahal	mahal-mahal
mahatma	maju sehat bersama
maho	homo
maininnya	memainkannya
mainkerjangampusngedate	main kerja kuliah kencan
mak	ibu
make	pakai
mak jang	kaget
makasi	terima kasih
makasih	terima kasih
makasii	terima kasih
makasiii	terima kasih
makasiiihh	terima kasih
makasiiiih	terima kasih
makasihhh	terima kasih
makenya	memakai
maksain	memaksa
malah	bahkan
malem	malam
maleman	malam
males	malas
mallshopee	mall shopee
malming	malam minggu
malu2in	memalukan
mam	makan
mamz	makan
manaa	mana
manamana	mana-mana
mandiii	mandi
maneh	kamu
manfaatin	memanfaatkan
mangtep	mantap
manies	manis
maniez	manis
manifesting	manifestasi
manifestinggg	manifestasi
manteman	teman-teman
mantep	mantap
mantul	mantap betul
mao	mau
mariii	mari
markicob	mari kita coba
markus	makelar kasus
masakmemasak	masak memasak
masi	masih
masukin	masukkan
masukkin	masukkan
matiin	mematikan
mauu	mau
mauuu	mau
maw	mau
mayan	lumayan
mba	mbak
mbaak	mbak
mbamba	mbak-mbak
mbakmbak	mbak-mbak
mbankingqris	mbanking qris
mcam	macam
mcm	macam
mcmana	bagaimana
medsos	media sosial
melembabkan	melembapkan
melu	ikut
membagongkan	membingungkan
membernya	anggotanya
memblok	memblokir
menangin	memenangkan
mencet	pencet
mending	lebih baik
menfess	pesan anonim
menuhin	memenuhi
mepet	dekat sekali
mesej	pesan
mevahhhhh	mewah
mfs	pesan anonim
mgkn	mungkin
mgu	minggu
mhn	mohon
migas	minyak dan gas bumi
miker	minuman keras
mikir	berpikir
mikol	minuman beralkohol
milih	memilih
milis	mailing list
minimalisbedside	minimalis bedside
minjem	meminjam
mintain	meminta
mintak	minta
miras	minuman keras
misuh	memaki
mjb	maaf join bareng
mka	maka
mkanya	makanya
mkin	makin
mksd	maksud
mksii	terima kasih
mlah	malah
mlihat	melihat
mls	malas
mmcm	maca
mmg	memang
mmin	admin
mmng	memang
mn	mana
mndiri	mandiri
mngkn	mungkin
mnt	minta
mo	mau
moge	motor gede
mokad	mati
mokat	mati
monggo	silakan
moots	teman
mootss	teman
morningg	pagi
morninggg	pagi
moso	masa
mosok	masa
motip	motif
mowning	pagi
mpe	sampai
mreka	mereka
msalah	masalah
msh	masih
msih	masih
msk	masuk
mskpn	meskipun
mslh	masalah
msng2	masing-masing
mt	makan teman
mu	kamu
muahal	mahal
mubes	musyawarah besar
mujamuja	memuja
muk	mau
muker	musyawarah kerja
mulu	melulu
muluu	melulu
mumet	pusing
mumpung	selagi
muna	munafik
munas	musyawarah nasional
munaslub	musyawarah nasional luar biasa
munculll	muncul
muntaber	muntah dan berak
muraah	murah
murce	murah
murmer	murah meriah
musda	musyawarah daerah
musti	mesti
mute	membisukan
muterin	memutar
mutual	teman
mutualan	berteman
mutualann	berteman
mutualannn	berteman
mutualsiapa	teman siapa
muup	maaf
muupz	maaf
muuv	maaf
mw	mau
mw	now watching
n	dan
nagih	ketagihan
naikin	menaikkan
naikkin	menaikkan
nak	mau
nakasmeja	nakas meja
nal	kenal
nambah	menambah
nambahin	menambahkan
nampakla	tampaklah
nanam	menanam
nangis	menangis
nangissssss	menangis
nanya	bertanya
nanyaa	bertanya
nanyain	menanyakan
nanyananya	bertanya-tanya
naon	apa
napa	kenapa
napa	kenapa
nape	kenapa
napi	narapidana
napol	narapidana politik
napza	narkotika, alkohol, psikotropika, dan zat adiktif 
naq	anak
narkoba	narkotika, psikotropika, dan obat terlarang
naro	menaruh
narsis	bangga pada diri sendiri
naruh	menaruh
nasgor	nasi goreng
nak	ingin
nautin	menautkan
nax	anak
nda	tidak
ndak	tidak
nder	teman
ndeeer	teman
nderr	teman
ndiri	sendiri
ndut	gendut
ne	ini
nebar	menyebar
neehhh	nih
nego	negosiasi
nekolim	neokolonialisme
nekolin	neokolonialisme
nelfon	menelepon
nembak	menyatakan cinta
nembus	menembus
nemenin	menemani
nempelin	menempelkan
nemu	ketemu
nemuin	menemukan
nemunya	ketemu
nerawang	menerawang
nerima	menerima
netes	menetas
newbi	anak baru
newbie	anak baru
ngabis2in	menghabiskan
ngabuburit	menunggu berbuka puasa
ngaco	mengada-ada
ngadain	mengadakan
ngadoin	memberi kado
ngafe	kumpul-kumpul
ngakak	tertawa
ngaku	mengaku
ngalamin	mengalami
ngalangin	menghalangi
ngambek	marah
ngambil	mengambil
ngampus	pergi ke kampus
ngandelin	mengandalkan
nganggur	tidak punya pekerjaan
ngantok	mengantuk
ngantor	bekerja
ngantri	mengantri
ngapa	kenapa
ngapah	kenapa
ngapain	melakukan apa
ngapainmakasi	kenapa terima kasih
ngapain makasi	kenapa terima kasih
ngape	kenapa
ngarang	mengarang
ngaret	terlambat
ngaruh	berpengaruh
ngasal	asal-asalan
ngasi	memberikan
ngasih	memberikan
ngasilin	menghasilkan
ngatasin	mengatasi
ngawur	berbicara sembarangan
ngebaca	membaca
ngebacotin	mengomeli
ngebajak	membajak
ngebalikin	membalikkan
ngebantu	membantu
ngebandel	berbuat bandel
ngebentuk	membentuk
ngeblock	memblokir
ngeblockin	memblokir
ngeblok	memblokir
ngeblokin	memblokir
ngeblokirin	memblokir
ngebul	mengepul
ngecek	memeriksa
ngeceng	kumpul bareng-bareng
ngedate	kencan
ngedit	mengedit
ngedrop	mengedrop
ngegosip	bergosip
ngeh	sadar
ngehubungin	menghubungi
ngehypeee	menyemangati
ngeklaim	mengklaim
ngeklik	memencet
ngekos	tinggal di kos
ngeksis	menjadi eksis
ngelamar	melamar
ngelanggar	melanggar
ngelanjutin	melanjutkan
ngelapak	berdagang
ngelempar	melempar
ngeles	berkilah
ngeliat	melihat
ngeliatin	melihat
ngeliatnya	melihatnya
ngelidur	mengigau
ngelike	menyukai
ngelirik	melirik
ngelive	melakukan siaran langsung
ngemeng	bicara terus-terusan
ngemute	membisukan
ngentot	berhubungan badan
ngepromosiinnya	mempromosikannya
ngeracun	merekomendasikan
ngeracunin	merekomendasikan
ngerampok	merampok
ngerasa	merasa
ngerasain	merasakan
ngerekomendasiin	merekomendasikan
ngeretweet	retweet
ngereview	mengulas
ngerti	paham
ngerusak	merusak
ngeselin	menyebalkan
ngeselinnnn	menyebalkan
ngeshare	membagikan
ngespam	spam
ngespill	mengungkapkan
ngestuck	terjebak
ngetweet	membuat tweet
ngga	tidak
nggak	tidak
nggapapa	tidak apa-apa
nggk	tidak
ngibul	berbohong
ngiklan	mengiklankan
ngikut	ikut
ngiler	mau
nginep	menginap
nginfoin	menginformasikan
ngiri	iri
ngirim	kirim
ngisi	mengisi
ngisiin	mengisikan
ngmg	bicara
ngmng	bicara
ngocol	lucu
ngomong	bicara
ngomongin	membicarakan
ngomongngomong	ngomong-ngomong
ngonten	membuat konten
ngopi	minum kopi
ngotak	memikirkan
ngubah	mengubah
ngubek2	mencari-cari
ngumpul	berkumpul
ngumpulin	mengumpulkan
nguntungin	menguntungkan
ngurangin	mengurangi
ngurus	mengurus
ngurusin	mengurus
ni	ini
nich	nih
nichh	nih
nichhh	nih
nie	ini
niech	nih
nih	ini
nihh	nih
nihhayo	nih ayo
nihhh	nih
niii	nih
niiii	nih
nimbrung	ikut serta
nindak	menindak
ningkatin	meningkatkan
nipu	menipu
nirfaedah	tidak berguna
nisekarang	nih sekarang
nitip	titip
niyh	nih
niyyy	nih
njir	anjing
njirrr	anjing
nkah	nikah
nmr	nomor
nmnya	namanya
nnt	nanti
nnti	nanti
nntk	nanti
nntn	nonton
nny	tanya
no	nomor
nobar	nonton bareng
nomer	nomor
nongki	kumpul-kumpul
nongkrong	kumpul-kumpul
notif	notifikasi
np	now playing
nrp	narapidana
ntar	nanti
ntar	sebentar
ntn	nonton
nuhun	terima kasih
nunggunya	menunggunya
nular	menular
nulis	menulis
numbuh	tumbuh
numpang	menumpang
numpuk	bertumpuk
nunggu	menunggu
nutupin	menutupi
nyambi	menyambi
nyambung	tersambung
nyambungin	menyambungkan
nyampah	membuat sampah
nyampe	sampai
nyadingin	menyandingi
nyangkut	tersangkut
nyantumin	mencantumkan
nyantuy	bersantai
nyatuyy	bersantai
nyari	mencari
nyariin	mencari
nyatet	mencatat
nyebar	menyebar
nyebelin	menyebalkan
nyebut	menyebut
nyekar	menyekar
nyelonong	menyelonong
nyepam	spam
nyeplak	timbul
nyerah	menyerah
nyerap	menyerap
nyesel	menyesal
nyesuaiin	menyesuaikan
nyetir	menyetir
nyewa	menyewa
nyiapin	mempersiapkan
nyicil	mencicil
nyiram	menyiram
nyisipin	menyisipkan
nyoba	coba
nyobain	mencoba
nyoblos	mencoblos
nyok	ayo
nyokap	ibu
nyolong	mencuri
nyolongin	mencuri
nyomot	mengambil
nyuri	mencuri
nyuruh	menyuruh
o/	oleh
ogah	tidak mau
ogos	agustus
ohiya	oh iya
ok	oke
okayyy	oke
okey	oke
okie	oke
okla	okelah
ol	online
olshop	online shop
olshopnyaa	online shopnya
omdo	omong doang
omo	astaga
omongin	membicarakan
ongkir	ongkos kirim
ongkirnya	ongkos kirimnya
onlen	online
oon	bodoh
oot	out of topic
ootd	outfit of the day
ootdstyle	outfit of the day style
oraaaang	orang
orangorang	orang-orang
org	orang
org2	orang-orang
orgnya	orangnya
ori	original
orkes	olahraga dan kesehatan
orng	orang
ortu	orang tua
ospek	orientasi studi dan pengenalan kampus
otda	otonomi daerah
otre	ok
otw	on the way, sedang di jalan
outerr	outer
outfit	pakaian
pa	apa
pabila	apabila
pacal	pacar
pacarny	pacarnya
pagiii	pagi
pagipagii	pagi-pagi
pagixx	pagi
pahe	paket hemat
pakcik	paman
pake	pakai
pakebalat	pakai alat
pakek	pakai
pakenya	pakainya
paksu	suami
pala	kepala
palagi	apalagi
panja	panitia kerja
panjangrok	panjang rok
pasanganny	pasangannya
pansus	panitia khusus
pantes	pantas
pantesan	pantas
pantura	pantai utara
pape	apa-apa
parpol	partai politik
pas2an	pas-pasan
pastiin	pastikan
pastu	setelah itu
pasutri	pasangan suami istri
patas	cepat dan terbatas
pb	powerbank
pd	pada
pda	pada
pdhal	padahal
pdhl	padahal
pede	percaya diri
pedes	pedas
pelatda	pemusatan latihan daerah
pelatnas	pemusatan latihan nasional
pelis	please
peliss	please
pemasukan	pendapatan
pembokat	pembantu
pemda	pemerintah daerah
pemilu	pemilihan umum
pemkot	pemerintah kota
pemprov	pemerintah provinsi
pemred	pemimpin redaksi
pencetin	memencet
pendaftaraan	pendaftaran
pendetector	pendeteksi
pending	tertunda
pengen	ingin
pengin	ingin
penjas	pendidikan jasmani
penjuall	penjual
penmas	pendidikan masyarakat
perabut	perabot
percoban	percobaan
perda	peraturan daerah
perati	perhatikan
perek	wanita tuna susila
perempuanlakilaki	perempuan laki-laki
perhatiin	perhatikan
pertamax	pertama
perushaan	perusahaan
pesanann	pesanan
pesen	pesan
pesenan	pesanan
pesenin	pesankan
pgang	pegang
pgi	pergi
pgn	ingin
pi	tapi
pict	picture
pijetin	pijitkan
pikiranye	pikirannya
pilkada	pemilihan kepala daerah
pilihcentangkan	pilih centangkan
pimpro	pemimpin proyek
pindahin	memindahkan
pinjem	pinjam
pinjol	pinjaman online
pisan	sangat
pisgor	pisang goreng
pk	penjahat kelamin
pke	pakai
plak	pula
pleasee	please
pleaseee	please
plg	paling
pling	paling
plis	please
pliss	please
plisss	please
plissss	please
pls	please
plss	please
plsss	please
plsplspls	please
plzzz	please
pm	private message
pmrnth	pemerintah
pngalamanya	pengalamannya
pnuh	penuh
pny	punya
pnya	punya
pokoknyaa	pokoknya
polantas	polisi lalu lintas
polll	pol
poloss	polos
polwan	polisi wanita
pon	pun
ponakkanamp	ponakan
ponpes	pondok pesantren
ponsel	telepon seluler
positip	positif
postkomen	post komentar
pp	promosi berbayar
ppa	apa
prg	pergi
priksa	periksa
printilan	barang-barang
printilannya	detailnya
prnah	pernah
prnh	pernah
pro	profesional
produkgt	produk gt
produkproduk	produk-produk
programpastiin	program pastikan
promoin	mempromosikan
promony	promonya
promooo	promo
promosiin	mempromosikan
promot	promosi
psen	pesan
psn	pesan
pst	pasti
psti	pasti
pswt	pesawat
puanas	panas
punten	permisi
punyaa	punya
puol	banget
pulak	pula
pw	posisi nyaman
qmo	kamu
qmu	kamu
qrt	quote reply
qrtnya	quote replynya
qt	kita
qtime	quality time
racunnn	racun
rakor	rapat koordinasi
ramairamai	ramai-ramai
rame	ramai
ramee	ramai
ranmor	kendaraan bermotor
raskin	rakyat miskin
ratingnya	peringkatnya
rban	ribuan
re	reply
realpict	gambar asli
rebuan	ribuan
red	redaksi
ref	referensi
reg	register
rehab	rehabilitasi
rejeki	rezeki
rek	rekening
rekeningshopeepay	rekening shopeepay
rekomedasiin	rekomendasikan
rekomen	rekomendasi
rekomend	rekomendasi
rekomendasiin	rekomendasikan
rekomendasiinnn	rekomendasikan
rekomendin	merekomendasikan
rekomin	rekomendasikan
rempong	sulit
renstra	rencana strategis
rep	balas
reply	balas
replyan	balasan
replydm	balas direct messege
repnya	balasannya
repp	balas
resahin	meresahkan
reskrim	reserse kriminal
restik	reserse narkotika
retweeet	retweet
reviewreview	review-review
revise	revisi
rhs	Rahasia
rhs	rahasia
ri	republik indonesia
ribet	tidak praktis
ribuannn	ribuan
ribuaannn	ribuan
ribuminggu	ribu minggu
ribuu	ribu
rmbt	rambut
rmh	rumah
rofl	rolling on the floor laughing
rokokvapeobatproduk	rokok vape obat produk
rs	rumah sakit
rt	retweet
rtcomment	rt comment
rtlike	rt like
rtlikee	rt like
rtrep	rt reply
ru	baru
rudal	peluru kendali
ruko	rumah toko
rulesnya	aturannya
ruparupanya	rupa-rupanya
rusun	rumah susun
rusunawa	rumah susun sewa
rutan	rumah tahanan
ruz	terus
s4	sempat
sabaarrrrr	sabar
sahaja	saja
saia	saya
saiank	sayang
saledapatkan	sale dapatkan
salinin	menyalin
salken	salam kenal
salmasalsabil	salma salsabil
salting	salah tingkah
saltum	salah kostum
salty	geram
samaaa	sama
samasama	sama-sama
sambel	sambal
sambungin	menyambungkan
sampahsampah	sampah-sampah
sampe	sampai
sampesampe	sampai
sampeyan	anda
samsek	sama sekali
saoing	saling
sapa	siapa
sape	siape
sapose	siapa
saranin	menyarankan
saranya	sarannya
satkorlak	satuan koordinator pelaksana
satpam	satuan pengamanan
satuuu	satu
say	sayang
sbb	sebab
sbenernya	sebenarnya
sbg	sebagai
sbh	sebuah
sblm	sebelum
sblmnya	sebelumnya
sbnrny	sebenarnya
sbnrnye	sebenarnya
scara	secara
scr	secara
scrolll	scroll
sdg	sedang
sdgkn	sedangkan
sdh	sudah
sdkt	sedikit
sdngkn	sedangkan
se7	setuju
seabrek	banyak
sebabb	sebab
sebabtu	sebab itu
sebagussss	sebagus
sebel	sebal
sebelas dua belas	mirip
sebelumsebelum	sebelum-sebelum
sebenernya	sebenarnya
secakep	sebagus
sedar	sadar
sedihdukakehilangan	sedih duka kehilangan
sediiih	sedih
sedikitsedikit	sedikit-sedikit
segede	sebesar
segemesh	sangat menggemaskan
segerr	segar
segiempat	segi empat
segini	sebanyak ini
seharihari	sehari-hari
seharihariku	sehari-hariku
seingetku	seingatku
sekedar	sekadar
sekjen	sekretaris jenderal
sekokah	sekolah
sekolahh	sekolah
sekolahkuliahkerja	sekolah kuliah kerja
seksa	siksa
selebgram	selebriti instagram
selebtiktok	selebriti tiktok
selebtwit	seleberiti twitter
selleraffiliate	seller affiliate
sellershopee	seller shopee
selo	santai
selucu	sangat lucu
semangatt	semangat
sembako	sembilan bahan pokok
sempak	celana dalam
sempet	sempat
sempet2nya	sempat-sempatnya
sempetsempetnya	sempat-sempatnya
semuaaaaaa	semua
semuaaaaaaa	semua
semuanyaaa	semuanya
sender	teman
sendiriin	memisahkan
sendratari	seni drama tari
senanggg	senang
seneng	senang
senengg	senang
sennggang	senggang
sensiviti	sensitivitas
seragman	seragaman
serame	seramai
serbaserbi	serba-serbi
serem	seram
sertain	menyertakan
sertijab	serah terima jabatan
seruu	seru
sesuain	sesuaikan
setsetelan	set setelan
sgt	sangat
sgtunya	segitunya
sharelink	share link
shg	sehingga
shoessneakers	shoes sneakers
shoopee	shopee
shopeeaffiliate	shopee affiliate
shopeelazadaonline	shopee lazada online
shopeemu	shopee kamu
shopeepayterima	shopeepay terima
shopeetiktok	shopee tiktok
shopeetiktoktokopedia	shopee tiktok tokopedia
shopeetiktoktokped	shopee tiktok tokopedia
shopeetokped	shopee tokopedia
shoper	shopee
shoppe	shopee
shopenya	shopeenya
shpee	shopee
siangje	siang saja
siapatau	siapa tahu
siape	siapa
siapin	siapkan
siapsiap	siap-siap
sidak	inspeksi mendadak
sidanggbentar	sidang bentar
sie	sih
siech	sih
sieee	sih
sieyh	sih
sihh	sih
sihhh	sih
sii	sih
siih	sih
siii	sih
sikecil	anak
sikit	sedikit
sikon	situasi dan kondisi
simpedes	simpanan pedesaan
simpen	simpan
sinetron	sinema elektronik
sip	ok
siramin	siramkan
sis	kakak perempuan
sj	saja
sjk	sejak
skali	sekali
skalian	sekalian
skena	sua cengkrama kelana
skirtrok	skirt rok
skl	sekali
sklh	sekolah
skrang	sekarang
skrg	sekarang
skrng	sekarang
sksd	sok kenal sok dekat
skt	sakit
skul	sekolah
slalu	selalu
slay	keren
slayy	keren
slesai	selesai
slh	salah
sll	selalu
slm	salam
slma	selama
slmt	selamat
slsai	selesai
slt	sulit
sm	sama
smangat	semangat
smga	semoga
smp	sampai
smpah	sampah
smpe	sampai
smpet	sempat
smpt	sempat
smua	semua
smw	semua
smwny	semuanya
sndiri	sendiri
sng	senang
snk	syarat dan ketentuan
soalnyamakasih	soalnya terima kasih
socmed	sosial media
sodara	saudara
sok	berlagak
soljum	sholat jumat
somse	sombong sekali
songong	sombong
sono	sana
sopi	shopee
sorang	sendiri
sorg	sendiri
sori	maaf
sorry	maaf
sory	maaf
sosbud	sosial-budaya
sosek	sosial-ekonomi
sosmed	sosial media
sosmednya	sosial medianya
sospol	sosial-politik
sotoy	sok tahu
sowry	maaf
spa	siapa
spd	sepeda
spg	sales promotion girl
sppa	siapa
sprti	seperti
spt	seperti
spupunya	sepupunya
spy	supaya
sribu	seribu
srtfkt	sertifikat
ss	screenshot
starshopee	star shopee
starup	startup
stelah	setelah
stiap	setiap
stiap	setiap
stlh	setelah
storenya	tokonya
stresstresnya	stres-stresnya
strika	setrika
subbag	subbagian
sudahbantal	sudah bantal
sue	sial
suer	benaran
suk	masuk
sumbangin	sumbangkan
sumpahh	sumpah
sumpek	sempit
sumpil	sumpah
sumpill	sumpah
sunggu	sungguh
supermarketstar	supermarket star
superr	super
surcin	surat cinta
survey	survei
surveynya	surveinya
sus	mencurigakan
suspnd	suspend
suujon	berburuk sangka
sy	saya
syg	sayang
syiopiii	shopee
syopi	shopee
syp	siapa
t4	tempat
tabanas	tabungan pembangunan nasional
taik	tai
tajir	kaya
tak	tidak
takdak	tidak ada
takde	tidak ada
takleh	tidak boleh
taknak	tidak mau
takpa	tidak apa
takpe	tidak apa
taktau	tidak tau
takyah	tidak payah
tambahin	tambahkan
tandain	menandai
tanyaaa	tanya
tanyain	tanyakan
tar	nanti
tau	tahu
taun	tahun
taunya	tahunya
tautin	menautkan
taw	tahu
tawarin	ditawarkan
tawh	tahu
taxnyaamp	pajaknya amp
tb	tinggi badan
tbtb	tiba-tiba
td	tadi
tdi	tadi
tdk	tidak
te2p	tetap
tebel	tebal
teguq	teguk
teh	kakak perempuan
tekor	rugi
tenkyuuult	terima kasih
telat	terlambat
tele	telegram
telkom	telekomunikasi
telmi	telat berpikir
telor	telur
telorr	telur
telp	telepon
temann	teman
temanteman	teman-teman
temen	teman
temenan	berteman
temenin	menemani
temenku	temanku
tementemen	teman-teman
temen2	teman-teman
temssss	teman-teman
tencuu	terima kasih
tengil	menyebalkan
tengkyu	terima kasih
tengkyuuu	terima kasih
tengok	melihat
tengoktengok	melihat-lihat
tengoklah	lihatlah
tepar	terkapar
tepek	tempel
terracyun	keracunan
terbitin	terbitkan
terimakasi	terima kasih
terimakasih	terima kasih
ternyt	ternyata
terparaah	terparah
terusss	terus
terworth	terlayak
testi	testimoni
teteh	kakak perempuan
tetep	tetap
tetiba	tiba-tiba
tggu	tunggu
tgk	lihat
tgl	tanggal
tgu	tunggu
thankiees	terima kasih
thankiuuu	terima kasih
thanks	terima kasih
thankssslt	terima kasih
thankyouu	terima kasih
thankz	terima kasih
thd	terhadap
thn	tahun
thx	terima kasih
tia	thanks in advace
tibatiba	tiba-tiba
tiketcoldplaygrab	tiket coldplay grab
tiktokshopee	tiktok shopee
tilang	bukti pelanggaran
tilkumsil	telkomsel
tinggalin	tinggalkan
tipi	TV
tipiwan	TvOne
titipnitip	penitipan
tk	tidak
tkg	tukang
tks	terima kasih
tktahu	tidak tahu
tkyah	tidak payah
tl	timeline
tll	terlalu
tlonk	tolong
tlp	telepon
tlpn	telepon
tls	tulis
tman	teman
tmbah	tambah
tmbh	tambah
tmen2	teman-teman
tmn	teman
tmn2	teman-teman
tmnin	menemani
tmnku	temanku
tmpah	tumpah
tmph	tumpah
tmpt	tempat
tnc	terms and conditions
tnda	tanda
tngu	tunggu
tnh	tanah
tnyta	ternyata
togel	toto gelap
tokai	tai
tokai	tai
tokped	tokopedia
tolongg	tolong
toserba	toko serba ada
tp	tapi
tpi	tapi
tq	terima kasih
trdhulu	terdahulu
trgntg	tergantung
trima	terima kasih
trims	terima kasih
trkait	terkait
trm	terima
trnyata	ternyata
trnyt	ternyata
trnyta	ternyata
trs	terus
trus	terus
trusted	tepercaya
trutama	terutama
trpngaruh	terpengaruh
trz	terus
ts	penulis
tsb	tersebut
tst	tahu sama tahu
tt	tiktok
ttd	tertanda
ttg	tentang
ttp	tetap
tu	itu
tubir	ribut
tuch	tuh
tuh	itu
tuir	tua
tuker	tukar
tutor	tutorial
tuwh	tuh
tw	tahu
tweets	tweet
twit	tweet
twitan	tweet
twiter	twitter
twitnya	tweetnya
twitt	tweet
twt	twitter
tyap	tiap
typingnya	ketikannya
tysm	thank you so much
tysmm	thank you so much
u	kamu
u/	untuk
ubat	obat
ubatsupplement	obat suplemen
ucul	lucu
ud	sudah
uda	sudah
udah	sudah
udh	sudah
ujan	hujan
ujg	ujung
ujung2nya	ujung-ujungnya
ul	ulangan
ultah	ulang tahun
ultahannivpernikahan	ulang tahun anniversary pernikahan
umumin	diumumkan
untk	untuk
unyu	lucu
unyu	menggemaskan
uplot	unggah
uppu	apa
urang	saya
urg	saya
urusin	urus
usah	perlu
utang	hutang
utk	untuk
utul	ujian tertulis
valas	valuta asing
validtidak	valid tidak
vc	voucher
verif	verifikasi
verifin	verifikasi
vidio	video
vidionya	videonya
viewers	penonton
viewersnya	penontonnya
voc	voucher
vol	volume
w/	dengan
wa	whatsapp
wad	buat
wadir	wakil direktur
wagub	wakil gubernur
walapon	walaupun
walopun	walaupun
wamil	wajib militer
wanginyaa	wanginya
wanitaa	wanita
waria	wanita pria
warkop	warung kopi
warnet	warung internet
warteg	warung tegal
wartel	warung telekomunikasi
wat	buat
wedgess	wedges
wes	sudah
wib	waktu indonesia barat
wita	waktu indonesia tengah
wisudaaa	wisuda
wk	tertawa
wkt	waktu
wktu	waktu
wkwk	tertawa
wkwkwk	tertawa
wkwkwkw	tertawa
wkwkwkwkwk	tertawa
wkwkkwkwkwkwk	tertawa
wlwpun	walaupun
worthit	worth it
wta	want to ask
wtb	want to buy
wtf	what the fuck
wth	what the hell
wts	want to sell
wtt	want to trade
xblh	tidak boleh
xde	tidak ada
xpernah	tidak pernah
xixixi	tertawa
xtau	tidak tahu
y	kenapa
ya	iya
yaa	iya
yaaa	iya
yaaah	iya
yaaaww	iya
yaahh	iya
yaak	iya
yaalink	ya link
yaang	yang
yaaw	iya
yaampunnn	ya ampun
yaampuun	ya ampun
yaarame	ya ramai
yach	iya
yad	yang akan datang
yahh	iya
yak	iya
yakk	iya
yakali	tidak mungkin
yakkkkk	iya
yap	iya
yapp	iya
yaps	iya
yapz	iya
yauda	ya sudah
yaudah	ya sudah
yaudahlah	ya sudahlah
yauwda	ya sudah
yaw	iya
yawdah	ya sudah
yaww	iya
yawwww	iya
yayy	yes
ybs	yang bersangkutan
ye	iya
yey	yes
yg	yang
ygy	ya guys ya
yh	iya
yhh	iya
yi	yaitu
yl	yang lain
yng	yang
yo	iya
yoha	iya
yok	ayo
yookkk	ayo
youuuu	you
yowes	ya sudah
yt	youtube
yuk	ayo
yukk	ayo
yukkk	ayo
yukkkk	ayo
yuks	ayo
yukss	ayo
yup	iya
yupp	iya
yuu	ayo
yuuk	ayo
yuukk	ayo
yuukkk	ayo
yuuu	ayo
yuuuk	ayo
yuuukk	ayo
yuuuu	ayo
ywdh	ya sudah
zuzur	jujur